{
    "patterns": [
        {
            "name": "level5",
            "data": [
                [0, 1, 2, 3, 4, 5, 6, 7, 8, 9],
                [1, 0, 1, 2, 3, 4, 5, 6, 7, 8],
                [2, 1, 0, 1, 2, 3, 4, 5, 6, 7],
                [3, 2, 1, 0, 1, 2, 3, 4, 5, 6],
                [4, 3, 2, 1, 0, 1, 2, 3, 4, 5],
                [5, 4, 3, 2, 1, 0, 1, 2, 3, 4],
                [6, 5, 4, 3, 2, 1, 0, 1, 2, 3],
                [7, 6, 5, 4, 3, 2, 1, 0, 1, 2],
                [8, 7, 6, 5, 4, 3, 2, 1, 0, 1],
                [9, 8, 7, 6, 5, 4, 3, 2, 1, 0]
            ]
        },
        {
            "name": "level1",
            "data": [
                [0, 0, 0, 0, 0, 0, 0, 0, 0, 0],
                [1, 1, 1, 1, 1, 1, 1, 1, 1, 1],
                [2, 2, 2, 2, 2, 2, 2, 2, 2, 2],
                [3, 3, 3, 3, 3, 3, 3, 3, 3, 3],
                [4, 4, 4, 4, 4, 4, 4, 4, 4, 4],
                [5, 5, 5, 5, 5, 5, 5, 5, 5, 5],
                [6, 6, 6, 6, 6, 6, 6, 6, 6, 6],
                [7, 7, 7, 7, 7, 7, 7, 7, 7, 7],
                [8, 8, 8, 8, 8, 8, 8, 8, 8, 8],
                [9, 9, 9, 9, 9, 9, 9, 9, 9, 9]
            ]
        },
        {
            "name": "level2",
            "data": [
                [0, 1, 2, 3, 4, 5, 6, 7, 8, 9],
                [0, 1, 2, 3, 4, 5, 6, 7, 8, 9],
                [0, 1, 2, 3, 4, 5, 6, 7, 8, 9],
                [0, 1, 2, 3, 4, 5, 6, 7, 8, 9],
                [0, 1, 2, 3, 4, 5, 6, 7, 8, 9],
                [0, 1, 2, 3, 4, 5, 6, 7, 8, 9],
                [0, 1, 2, 3, 4, 5, 6, 7, 8, 9],
                [0, 1, 2, 3, 4, 5, 6, 7, 8, 9],
                [0, 1, 2, 3, 4, 5, 6, 7, 8, 9],
                [0, 1, 2, 3, 4, 5, 6, 7, 8, 9]
            ]
        },
        {
            "name": "level3",
            "data": [
                [0, 1, 2, 3, 4, 5, 6, 7, 8, 9],
                [9, 0, 1, 2, 3, 4, 5, 6, 7, 8],
                [8, 9, 0, 1, 2, 3, 4, 5, 6, 7],
                [7, 8, 9, 0, 1, 2, 3, 4, 5, 6],
                [6, 7, 8, 9, 0, 1, 2, 3, 4, 5],
                [5, 6, 7, 8, 9, 0, 1, 2, 3, 4],
                [4, 5, 6, 7, 8, 9, 0, 1, 2, 3],
                [3, 4, 5, 6, 7, 8, 9, 0, 1, 2],
                [2, 3, 4, 5, 6, 7, 8, 9, 0, 1],
                [1, 2, 3, 4, 5, 6, 7, 8, 9, 0]
            ]
        },
        {
            "name": "level6",
            "data": [
                [3, 7, 8, 2, 5, 1, 6, 4, 0, 9],
                [6, 4, 9, 7, 1, 8, 3, 2, 5, 0],
                [2, 8, 0, 5, 9, 7, 1, 3, 6, 4],
                [9, 6, 3, 1, 4, 0, 8, 5, 7, 2],
                [4, 0, 1, 3, 2, 6, 7, 9, 8, 5],
                [1, 5, 2, 8, 0, 3, 9, 7, 4, 6],
                [7, 9, 5, 6, 8, 4, 0, 1, 2, 3],
                [8, 2, 4, 0, 7, 9, 5, 6, 3, 1],
                [5, 3, 7, 9, 6, 2, 4, 8, 1, 0],
                [0, 1, 6, 4, 3, 5, 2, 0, 9, 7]
            ]
        },
        {
            "name": "level4",
            "data": [
                [0, 1, 2, 3, 4, 5, 6, 7, 8, 9],
                [1, 2, 3, 4, 5, 6, 7, 8, 9, 0],
                [2, 3, 4, 5, 6, 7, 8, 9, 0, 1],
                [3, 4, 5, 6, 7, 8, 9, 0, 1, 2],
                [4, 5, 6, 7, 8, 9, 0, 1, 2, 3],
                [5, 6, 7, 8, 9, 0, 1, 2, 3, 4],
                [6, 7, 8, 9, 0, 1, 2, 3, 4, 5],
                [7, 8, 9, 0, 1, 2, 3, 4, 5, 6],
                [8, 9, 0, 1, 2, 3, 4, 5, 6, 7],
                [9, 0, 1, 2, 3, 4, 5, 6, 7, 8]
            ]
        }
    ]
}
